=============
=   t    t  =
=v  = ===== =
===== ===a  =
=m    ==    =
== =====    =
=  k==== Z  =
=========t===
=Z        ===
=A ===x======
=s===========
